{
  "grid": [
    "###############",
    "#P....#....G..#",
    "#.###.#.###.#.#",
    "#....T....S...#",
    "#.###.#.###.#.#",
    "#.....#..I..#.#",
    "#.###.###.###.#",
    "#.............#",
    "#.###.#.###.#.#",
    "###############"
  ]
} 